Song	Artist	Lyrics
Movin' on without you	浜崎あゆみ	
Cool	Gwen Stefani	
Lil Watan	Mashrou' Leila	
Goodbye Happiness	宇多田ヒカル	
Josephine	Yeng Constantino	
This Is How I Disappear	My Chemical Romance	
Red Sky	Thrice	
마지막 인사	Bigbang	
Bored Rigid	COMEBACK MY DAUGHTERS	
Genei no Kusari	Screw	
Blurry Eyes	L'Arc~en~Ciel	
MUTE	ESTi x TAK feat. Sanch	
相愛後動物感傷	張惠妹	
E Is For Estranged	Owen Pallett	
Alone in the dark	COMEBACK MY DAUGHTERS	
Emily	Joanna Newsom	
桜流し	宇多田ヒカル	
TRAP	Meg	
House of Balloons / Glass Table Girls	The Weeknd	
When You Were Young	The Killers	
The Earth Will Shake	Thrice	
Spending all my time	Perfume	
Raasuk	Mashrou' Leila	
Langis at Tubig	Juris	
Chiquitita	Laleh	
Sonic - Star Light Zone	Smooth McGroove	
Baptism	Crystal Castles	
Ala Babu	Mashrou' Leila	
Something	JMSN	
For Miles	Thrice	
My Silver Lining	First Aid Kit	
Chiquitita	ABBA	
Atlantic	Thrice	
Heads Will Roll	Yeah Yeah Yeahs	
Primadonna	Marina & the Diamonds	
You Only Live Once	The Strokes	
The Island: You'll Not Feel the Drowning (ver. horizon)	Horizon	
格雷的畫像	韋禮安	
Drag Queen	The Strokes	
Bint Elkhandaq	Mashrou' Leila	
主演の女	椎名林檎	
星から来たあなた	ユンナ	
Citizen Erased	Muse	
STUPiG	Bis	
We Flood The Night	FEMM	
Icarus	Mashrou' Leila	
I'm Your Man (Cover)	Zessei Bijin!	
Human Sadness	Julian Casablancas + The Voidz	
Maghawir	Mashrou' Leila	
ain't afraid to die	DIR EN GREY	
떠나지마	딕펑스	
Shine	Casey Lee Williams	
Caffeine (feat. Lamar Hall)	Casey Lee Williams	
Time to Say Goodbye	Casey Lee Williams	
Unrequited Love	Capsule	
The Heretic	The Sound of Animals Fighting	
Between The End And Where We Lie	Thrice	
Ode To The Sun	dredg	
No Transitory	Alexisonfire	
Welcome Home	Coheed and Cambria	
This Could Be Anywhere In The World	Alexisonfire	
DiE	Bis	
青春の瞬き	椎名林檎	
All My Stars Aligned	St. Vincent	
Only Skin	Joanna Newsom	
Ghosts	Ibeyi	
Gold (feat. Casey Lee Williams)	Jeff Williams	
渦中の男	椎名林檎	
Vanitas	DIR EN GREY	
I Can Change	Brandon Flowers	
DEATH	::M∆DE::IN::HEIGHTS::	
Dare I Care	Julian Casablancas + The Voidz	
Trying Your Luck	The Strokes	
流転の塔	DIR EN GREY	
I'm Feeling You	Capsule	
Again (Cover)	CollaboDaisakusen	
Addicted To You [UP-IN-HEAVEN MIX]	宇多田ヒカル	
Stay Gold	宇多田ヒカル	
Hurry Xmas	L'Arc~en~Ciel	
COLORS	宇多田ヒカル	
Silent Eve	Sadie	
I was Wrong	Capsule	
LOST HEAVEN	L'Arc~en~Ciel	
Nemuri Ni Yosete	L'Arc~en~Ciel	
Of Dust And Nations	Thrice	
Herzan	Soap Kills	
I Can't Smile At Everyone	Ken Yokoyama	
Konayuki	レミオロメン	
M.F.P(Malicious Female Pigs)	Sadie	
Psycho Culture	Sadie	
MAD-ROID	Sadie	
windress	Versailles	
The Umbrella of Glass	Versailles	
Catharsis	Versailles	
星ノ雨	ViViD	
Bright red garden	ViViD	
きらきら武士 feat. Deyonna	レキシ	
Poster of a Girl	Metric	
Alcohol Bottle	haha	
Meisai	Sadie	
Icky Thump	The White Stripes	
Niji	L'Arc~en~Ciel	
Promenade	Közi	
DAHLIA	X Japan	
Seven Nation Army	The White Stripes	
激しさと、この胸の中で絡み付いた灼熱の闇	DIR EN GREY	
Apple with Ringo Sheena	Towa Tei	
год безделий	Buhar Jerreau	
RUIN AND DREAD	Screw	
DYSPNEA	Screw	
WORLD OF FANTASY	Capsule	
我、闇とて･･･	DIR EN GREY	
Some Die Young	Laleh	
Stay with You	Capsule	
JUMPER	Capsule	
Siguro	Yeng Constantino	
Sonic - Marble Zone	Smooth McGroove	
Tell Me	Hide	
JEALOUS	DIR EN GREY	
I'm Just Your Problem (Cover)	Elena Íviel Berciano feat. Nicole Vaquerano	
ROCKSTAR	Meg	
Bust Your Knee Caps	Pomplamoose	
Fly	Hilary Duff	
Time goes on	L'Arc~en~Ciel	
3cmディスタンス	Saoriiiii	
cosmic world	Alice Nine	
メギツネ	BABYMETAL	
小夜子 (Cover)	Antares	
Boiled Frogs	Alexisonfire	
Euterpe (Cover)	Horizon	
Derse Dreamers (Cover)	Horizon	
眠り姫 (Cover)	Koko	
Soft as Chalk	Joanna Newsom	
Taekwondo (Produced by GRAY)	Jay Park	
Jesus Christ	Hyde	
Wannabe	FEMM	
Different Sense	DIR EN GREY	
Key Entity Extraction II: Holly Wood the Cracked	Coheed and Cambria	
Hello	Capsule	
Zoetrope (Cover)	CollaboDaisakusen	
Key Entity Extraction IV: Evagria The Faithful	Coheed and Cambria	
Flavor Of Life	ハナレグミ	
盛夏光年	五月天	
Stand And Feel Your Worth	Thrice	
Wag Na Wag Mong Sasabihin	Kitchie Nadal	
498	Buhar Jerreau	
Pagan Poetry	Björk	
The Ghost of You	My Chemical Romance	
AGITATED SCREAMS OF MAGGOTS	DIR EN GREY	
真実と幻想と	L'Arc~en~Ciel	
Maboroshi	NoGoD	
記憶と空	Malice Mizer	
RED SOIL	DIR EN GREY	
Love Is War (Feat.Outsider)	길미	
Flying a Kite	Joanna Newsom	
Black Escaflowne	菅野よう子	
Nocturnal Romance	Moi dix Mois	
Always	Neverending White Lights	
Wajih	Mashrou' Leila	
DOZING GREEN	DIR EN GREY	
Big Time Sensuality	Björk	
Eat You Up	Boa	
NEW DAYS DAWN	Hyde	
MY HEART DRAWS A DREAM (hydeless)	L'Arc~en~Ciel	
Mother (Cover)	Horizon	
Spirals	L'Arc~en~Ciel	
恋愛サーキュレーション (English Cover)	Lizz	
従属ふりったー (Cover)	Antares	
Fools	The Ransom Collective	
Swim Good	Frank Ocean	
It's Oh So Quiet	Björk	
I Believe (feat. Kat McDowell)	DAISHI DANCE	
Like Moths To Flame	Thrice	
暁	DIR EN GREY	
1582	KAT-TUN	
Gossip (English Cover)	Ashe	
Blame It On The Girls	Mika	
Steady, as She Goes	The Raconteurs	
Thinkin Bout You	Frank Ocean	
Feel Good Inc.	Gorillaz	
Keep Tryin'	宇多田ヒカル	
Gravemakers & Gunslingers	Coheed and Cambria	
DOZING GREEN (Japanese Lyrics Re-mastering)	DIR EN GREY	
GARDEN	DIR EN GREY	
violent parade	acid android	
INCONVENIENT IDEAL	DIR EN GREY	
Crimson Star	Közi	
Nocturne	Közi	
Torn	Natalie Imbruglia	
Amon	DIR EN GREY	
命のユースティティア (Cover)	Tokyo Magnitude 420	
Seventh Heaven	L'Arc~en~Ciel	
Key Entity Extraction III: Vic the Butcher	Coheed and Cambria	
How Insensitive	Astrud Gilberto	
ISM	Közi	
You Heartbreaker	Dojo Workhorse	
SECRET LETTERS	Hyde	
OASIS	Hyde	
Lady Luck	Jamie Woon	
Eyes on Me	王菲	
Valerie	Amy Winehouse	
あなた	Acid Black Cherry	
I Have a Dream	ABBA	
The Winner Takes It All	ABBA	
HATE	Charisma.com	
Sunadokei	L'Arc~en~Ciel	
Sunrise	Hanaboy	
Koishikute	UVERworld	
S.T.F.U.	ギルガメッシュ	
FREELY TOMORROW	初音ミク	
너 아님 안돼	2NE1	
Jóga	Björk	
Oceania	Björk	
Obsessed	Boa	
Good Day (Japanese Cover)	Zessei Bijin!	
Butterfly's Sleep	L'Arc~en~Ciel	
COLORS	Flow	
Sarabande (Cover)	Horizon	
No World For Tomorrow	Coheed and Cambria	
ZEROTICA	XA-VAT	
EXISTENCE	L'Arc~en~Ciel	
Killing Me Softly (Cover)	The Jackson 5	
Bakit?	Cueshé	
瞳の住人	L'Arc~en~Ciel	
DAYS	Flow	
ANGEL'S TALE	Hyde	
flower	L'Arc~en~Ciel	
Hitomi no Junnin	L'Arc~en~Ciel	
Be Strong	Yazumi Kana	
DARE	Gorillaz	
Glass Skin	DIR EN GREY	
WAVE (Cover)	Himistuni	
Merry Christmas Mr. Lawrence (1996 Live)	坂本龍一	
Shiroi Yuki no Princess Wa ft. Akatsuki Taiyou& ZODIAC	Zessei Bijin!	
Link -KISS Mix-	L'Arc~en~Ciel	
The Hound (of Blood and Rank)	Coheed and Cambria	
Beast of Blood	Malice Mizer	
Don't Let Me Fall	B.o.B	
Unravel (Cover)	りょ子	
GLASS SKIN (Japanese Lyrics Re-mastering)	DIR EN GREY	
Will There Really Be A Morning? (Live Cover)	Ashe	
獣慾	DIR EN GREY	
Anna Molly	Incubus	
Lies and Truth	L'Arc~en~Ciel	
기대해	Girl's Day	
KISS OR BITE	Meg	
Heavens Drive (Live)	L'Arc~en~Ciel	
White Feathers	L'Arc~en~Ciel	
Baptism of Blood	Malice Mizer	
Feeling Fine	L'Arc~en~Ciel	
Trail of Tears	ViViD	
Chase the Morning	Darren Smith & Terrance Zdunich	
Nervous and Innocence	Eve of Destiny	
Approximately Gone	Sophie Hunger	
DESTINY -The Lovers-	Versailles	
REPETITION OF HATRED	DIR EN GREY	
Key Entity Extraction I: Domino the Destitute	Coheed and Cambria	
星の無い夜に	DELUHI	
The Grace	Neverending White Lights	
THE GHOST IN MY ROOM	L'Arc~en~Ciel	
Step on The Floor	Capsule	
Hither	The Ransom Collective	
I May Fall (feat. Casey Lee Williams)	Jeff Williams	
OBSCURE (remake)	DIR EN GREY	
Obscure	DIR EN GREY	
No More Perfume On You	TEEN TOP	
Megu Megu Romantic Fever ft. Carlos, Joel, Jurian (Cover)	Akatsuki Taiyou	
Link	L'Arc~en~Ciel	
Kremlin Dusk	Utada	
Jasper	木村カエラ	
It's in Our Hands	Björk	
Interviewer-インタビュア (English Cover)	JoyDreamer	
IA IA Night of Desire (Cover)	Zessei Bijin!	
I think I can fly	ギルガメッシュ	
I Did It For Love	Boa	
Hyperballad	Björk	
Honey Vanity	Közi	
Hawak Kamay	Yeng Constantino	
Have One on Me	Joanna Newsom	
Hama	Boris	
Galileo (Someone Like You)	Declan O'Rourke	
freesia	ムック	
forbidden lover	L'Arc~en~Ciel	
Fly Me To The Moon (Mike Brown Remix Cover)	宇多田ヒカル	
Ezio's Family (Metal Cover)	Warialasky	
Eyes Love You [tt mix]	Hide	
Easy	Joanna Newsom	
Downtime (Cover)	Horizon	
Deliver Us	Ofra Haza	
Lapit	Yeng Constantino	
Skandar Maalouf	Mashrou' Leila	
CONCEIVED SORROW	DIR EN GREY	
Can't take my eyes off of you	Tommy february6	
Be My Last	宇多田ヒカル	
Bachelorette	Björk	
ART OF LIFE	X Japan	
Angel Heart	START OF THE DAY	
All Dead	L'Arc~en~Ciel	1
A Drop of Color	Hyde	
愛Dee (Cover ft. Renna)	Ikon	
The Cape Of Storms	Hyde	
SHALLOW SLEEP	Hyde	
WHITE SONG	Hyde	
UNEXPECTED	Hyde	
Wings (feat. Casey Lee Williams)	Jeff Williams	
カスガイ	チリヌルヲワカ	
Caress of Venus	L'Arc~en~Ciel	
darkness rabbit	COLTEMONIKHA	
Lost and Found	Horizon	
GOOD LUCK MY WAY	L'Arc~en~Ciel	
Текстиль	Buhar Jerreau	
God Palace -Method of Inheritance-	Versailles	
happiness!!!	木村カエラ	
Shim El Yasmine	Mashrou' Leila	
VINUSHKA	DIR EN GREY	
Coming Closer	L'Arc~en~Ciel	
Mister Sandman	Pomplamoose	
Let Me Go ! (Feat. Sophie Hunger)	Erik Truffaz Quartet	
Wrong Side of the Sun	Sophie Ellis-Bextor	
Novacane	Frank Ocean	
Rise And Fall	Sophie Hunger	
Kaikou	Közi	
Lies And Truth (Hydeless)	L'Arc~en~Ciel	
Unravel (Dupstep Cover)	Poucet	
Kunin Mo Na Ang Lahat Sa Akin	Angeline Quinto	
Only Human (Piano Version)	Susumu Ueda	
Miss Murder	AFI	
The Book of Right-on (live)	Joanna Newsom	
Goodnight, Fair Lady	Coheed and Cambria	
Pink Spider	Hide	
Flare Gun	Owen Pallett	
PRECIOUS	ViViD	
一途な片思い、実らせたい小さな幸せ。 (Cover)	Katie	
Бармен	Buhar Jerreau	
Flare (Cover)	Horizon	
Pyrocumulus (Sicknasty Cover)	Horizon	
サリシノハラ (English Cover)	Nami	
Чиновник	Buhar Jerreau	
桜流し (Cover)	Sugar Joiko	
RED SOIL [LIVE]	DIR EN GREY	
할말 있어요	승리	
retro memory	Capsule	
步步	五月天	
The Book of Right-On	Joanna Newsom	
Apollo I: The Writing Writer	Coheed and Cambria	
田中理恵 (Cover)	Horizon	
THE PLEDGE	DIR EN GREY	
vestige	Moi dix Mois	
春と修羅	downy	
サリシノハラ (Cover)	きむにゅ	
THE PLEDGE (acoustic)	DIR EN GREY	
Sayounara	L'Arc~en~Ciel	
Plastic Girl (feat. EeL)	Capsule	
What is love	L'Arc~en~Ciel	
Rose	이하이	
擁抱 (日本語)	五月天	
楽園	indigo la End	
Cosmia	Joanna Newsom	
CLEVER SLEAZOID	DIR EN GREY	
West Coast (Cover)	Jhóna	
Standing Still (Cover)	peuyeumus	
Unravel (English Cover)	りょ子	
ネトゲ廃人シュプレヒコール (Cover)	chesu	
Unravel	Björk	
摩托車日記	五月天	
Mirror Mirror (Rooster Teeth's Rwby White Trailer) [feat. Casey Williams]	Jeff Williams	1
Scream	2NE1	
Gold feat Casey Lee Williams	Jeff Williams feat Casey Lee Williams	
Ten Speed (Of God's Blood & Burial)	Coheed and Cambria	
舞風 ft. Saint (Cover)	ロザー	
おやすみ	tricot	
Crossing The Frame	Coheed and Cambria	
One Life	The Pillows	
Sweet Dream	MFBTY	
Day by Day	T-ARA	
Vi-Vi-Vi	Sug	
Discovering the Waterfront	Silverstein	
Hyperballad	Robyn	
4:00AM	Luna Sea	
ないものねだり	KANA-BOON	
Мост	Buhar Jerreau	
As If in a Dream	L'Arc~en~Ciel	
The Blossoming Beelzebub	DIR EN GREY	
Coelacanth (Cover)	BACKSLASH/Mari/Acca/Rimi/Cola	
心の色	Acid Black Cherry	
썸씽	Girl's Day	
Birthday Eve	倖田來未	
Palette (Cover)	エミ	
Good-bye days	YUI	
So	Typhoon	
tentation	Moi dix Mois	
オデッセイ・1985・SEX	MERRY	
Girls (Cover)	Maria	
Good Intentions Paving Company	Joanna Newsom	
소년이여	G-Dragon	
Lotus	DIR EN GREY	
Mothers of Men	Coheed and Cambria	
The Afterman	Coheed and Cambria	
Anemone	L'Arc~en~Ciel	
Back to Black	Amy Winehouse	
Dybbuk	GACKT	
Let Me Go ! - feat. Sophie Hunger	Erik Truffaz Quartet	
我不願讓你一個人	五月天	
again	YUI	
I Burn ft. CDanielART (Extended Version)	Jeff Williams	
Somebody To Love	ClubSoda	
Doom Dada	T.O.P	
All Dead (Guitar Cover)	hha1993	
MaGic in youR Eyes	Tommy february6	
Once Upon Your Dead Body	Coheed and Cambria	
バビロン (Cover)	俊	
one summer night (ft. tasha)	Drunken Tiger	
Trollcops (Cover)	Horizon	
Forget You (Clean)	CeeLo Green	
エレクトロ・ワールド	Perfume	
Pieces [ark mix]	L'Arc~en~Ciel	
Fare Well	L'Arc~en~Ciel	
Mister (Cover)	Zessei Bijin!	
Bad Boy	Bigbang	
Cocoon	Björk	
makka na ito	Plastic Tree	
PONPONPON	きゃりーぱみゅぱみゅ	
Dancer in the Dark	巡音ルカ	
Promise	Yeng Constantino	
Crazy's crew	The Fool	
HONEY	L'Arc~en~Ciel	
我不願讓你一個人 (Cover)	Kien Seng Swee	
星空	五月天	
Game	ムック	
Земляне	Buhar Jerreau	
波紋	ViViD	
Monster	Bigbang	
Jelly	Capsule	
我不願讓你一個人 (Cover)	高豪力	
LEECH	the GazettE	
Cruel Arcadia	Közi	
Love	Cinemaglam	
Just Be Friends	巡音ルカ	
L's Theme B	Death Note	
サリシノハラ (Acoustic Cover)	りょ子	
HEAVEN'S DRIVE	L'Arc~en~Ciel	
VS	misono	
Fairytale (Cover)	りょ子	
WIND	KAT-TUN	
Aventure	ゆよゆっぺ	
UTAKATA	Speed	
Filth in the beauty	the GazettE	
confusion	Sadie	
Ikenai Taiyou	ORANGE RANGE	
Give Me Novacaine	Green Day	
secret	巡音ルカ	
DYE	巡音ルカ	
害虫	ヲタ姐	
「un-」	KAT-TUN	
Kamikaze	NoGoD	
Haru Haru	Bigbang	
I'm so happy	L'Arc~en~Ciel	
Retsu	DANGER☆GANG	
Pretty girl	L'Arc~en~Ciel	
Blame	L'Arc~en~Ciel	
Uzu	Kagrra,	
Ichirin no Hana	High And Mighty Color	
Incoherents	Közi	
Grottesca	Közi	
Kaikou (Inst)	Közi	
Tsukiyo	Közi	
Stand by me	The Brilliant Green	
All the Things She Said	t.A.T.u.	
Only Human	K	
#1 (English Version)	자우림	
CHILD PREY	DIR EN GREY	
GLASS SKIN (English Version)	DIR EN GREY	
Vizard	Moi dix Mois	
Kasou	L'Arc~en~Ciel	
DRINK IT DOWN	L'Arc~en~Ciel	
Aozora	NoGoD	
Longing (Unchained Melody)	X Japan	
Ophelia	L'Arc~en~Ciel	
Ibara no namida	L'Arc~en~Ciel	
Round and Round	L'Arc~en~Ciel	
It's Not a Fashion Statement, It's a Deathwish	My Chemical Romance	
涙雨～なみだあめ ft. Sabi (Cover)	Poucet	
Breeding	Hide	
짧은 치마	AOA	
twinkle, twinkle	L'Arc~en~Ciel	
Ultimate 4	ギルガメッシュ	
shirasagi	NoGoD	
MY HEART DRAWS A DREAM	L'Arc~en~Ciel	
Eien	L'Arc~en~Ciel	
Killing Me	L'Arc~en~Ciel	
Bad	Tablo	
STAY AWAY	L'Arc~en~Ciel	
Shion	ムック	
get out from the shell	L'Arc~en~Ciel	
aito Kanashimino Nocturne	Versailles	
傷心的人別聽慢歌 (貫徹快樂)	五月天	
Ready, Steady, Go!	L'Arc~en~Ciel	
Aristocrat's Symphony	Versailles	
Entichers	L'Arc~en~Ciel	
Pieces	L'Arc~en~Ciel	
LOVE FLIES	L'Arc~en~Ciel	
Turn It Up (Intro)	이하이	
Lover Boy	L'Arc~en~Ciel	
滴る朦朧	DIR EN GREY	
nobody	ギルガメッシュ	
Zetsubu Billy	Maximum the Hormone	
小夜子 (English Acoustic Cover)	Antares	
Baroque	Malice Mizer	
Pussy Dance	The Fool	
Ever Free	Hide	
Leather Face	Hide	
ぶっ生き返す!!	Maximum the Hormone	
A Little Less Sixteen Candles, A Little More Touch Me	Fall Out Boy	
Mayonaka no Denwa	Capsule	
Ugly (Japanese Version Cover)	Zessei Bijin!	
Rolling Girl (Cover)	Antares	
CLEVER SLEAZOID (Cover)	初音ミク	
Fuyu Tokyo	LAREINE	
dress	abingdon boys school	
Lovers	7!!	
Karakuri	いきものがかり	
DOUBT '97	Hide	
Defended Desire	Aldious	
アイモ (Acapella Cover)	Horizon	
君がいない間に(Piano inst)	ゴールデンボンバー	
Anata	松田聖子	
Ascendead Master (album remaster)	Versailles	
Hikari	宇多田ヒカル	
Merry Christmas Mr. Lawrence - FYI	宇多田ヒカル	
Seishun Kyousoukyoku	Sanbomasutau	
ALUMINA	Nightmare	
That XX (Cover)	Arlene & Angky Budiardjono	
Kasanaru Kage	Hearts Grow	
Heavenly Star	Genki Rockets	
Megu Megu Romantic Fever ft. Carlos, Joel, Jurian	Akatsuki Taiyou	
Ukifune	GO!GO!7188	
SCREAM	Zessei Bijin!	
Mister	Zessei Bijin!	
Last Farewell	Bigbang	
Sayoko	Antares	
Sayoko (English Acoustic)	Antares	
Koishikute	Aokicchi	
オデッセイ・1985・SEX(Michiro,Get the Help!)	MERRY	
Lonely In Gorgeous (Paradise kiss OST)	Tommy february6	
Paran	Koyote	
カクセイ	NoGoD	
Utakata [Cover]	Stephanie	
